00000000
00000000
0G000000
11111111
00001000
000010H0
00P01000
11111111

00H01000
00001000
00001000
00001000
00001000
00001000
00001000
00001000