00001000
000010G0
00001000
11111111
00001000
000010H0
00P01000
11111111

00001000
00H01000
00001000
00001000
00001000
00001000
00001000
00001000