00000000
00000000
00000B00
00100000
000P0000
00100000
10000H00
00000000

00000000
00000000
00H00000
00000000
00000000
00000000
00000000
00000000